3 9
5 1
7 20
%%%%%%%%%%%%%%%%%%%%
%--------------%---%
%-%%-%%-%%-%%-%%-%-%
%--------P-------%-%
%%%%%%%%%%%%%%%%%%-%
%.-----------------%
%%%%%%%%%%%%%%%%%%%% 
